filename, language, JavaScript, JSON, HTML, Vue, Markdown, comment, blank, total
d:\OneDrive\Code\Vscode\Vue\qingblog\.eslintrc.js, JavaScript, 18, 0, 0, 0, 0, 0, 1, 19
d:\OneDrive\Code\Vscode\Vue\qingblog\README.md, Markdown, 0, 0, 0, 0, 21, 0, 5, 26
d:\OneDrive\Code\Vscode\Vue\qingblog\babel.config.js, JavaScript, 5, 0, 0, 0, 0, 3, 3, 11
d:\OneDrive\Code\Vscode\Vue\qingblog\package-lock.json, JSON, 0, 11861, 0, 0, 0, 0, 1, 11862
d:\OneDrive\Code\Vscode\Vue\qingblog\package.json, JSON, 0, 47, 0, 0, 0, 0, 1, 48
d:\OneDrive\Code\Vscode\Vue\qingblog\public\index.html, HTML, 0, 0, 16, 0, 0, 1, 1, 18
d:\OneDrive\Code\Vscode\Vue\qingblog\qingblog\package.json, JSON, 0, 10, 0, 0, 0, 0, 0, 10
d:\OneDrive\Code\Vscode\Vue\qingblog\src\App.vue, Vue, 0, 0, 0, 29, 0, 0, 5, 34
d:\OneDrive\Code\Vscode\Vue\qingblog\src\axios\axios.js, JavaScript, 24, 0, 0, 0, 0, 7, 5, 36
d:\OneDrive\Code\Vscode\Vue\qingblog\src\components\ABlog.vue, Vue, 0, 0, 0, 123, 0, 10, 3, 136
d:\OneDrive\Code\Vscode\Vue\qingblog\src\components\HelloWorld.vue, Vue, 0, 0, 0, 30, 0, 0, 4, 34
d:\OneDrive\Code\Vscode\Vue\qingblog\src\components\Navigation.vue, Vue, 0, 0, 0, 104, 0, 1, 1, 106
d:\OneDrive\Code\Vscode\Vue\qingblog\src\main.js, JavaScript, 23, 0, 0, 0, 0, 0, 3, 26
d:\OneDrive\Code\Vscode\Vue\qingblog\src\router\index.js, JavaScript, 58, 0, 0, 0, 0, 13, 6, 77
d:\OneDrive\Code\Vscode\Vue\qingblog\src\store\index.js, JavaScript, 14, 0, 0, 0, 0, 0, 3, 17
d:\OneDrive\Code\Vscode\Vue\qingblog\src\utils\request.js, JavaScript, 33, 0, 0, 0, 0, 2, 8, 43
d:\OneDrive\Code\Vscode\Vue\qingblog\src\views\blog\EditBlog.vue, Vue, 0, 0, 0, 227, 0, 59, 7, 293
d:\OneDrive\Code\Vscode\Vue\qingblog\src\views\blog\ViewBlog.vue, Vue, 0, 0, 0, 385, 0, 47, 5, 437
d:\OneDrive\Code\Vscode\Vue\qingblog\src\views\home\Home.vue, Vue, 0, 0, 0, 107, 0, 7, 4, 118
d:\OneDrive\Code\Vscode\Vue\qingblog\src\views\login\Login.vue, Vue, 0, 0, 0, 110, 0, 2, 3, 115
d:\OneDrive\Code\Vscode\Vue\qingblog\src\views\login\Register.vue, Vue, 0, 0, 0, 121, 0, 2, 4, 127
d:\OneDrive\Code\Vscode\Vue\qingblog\src\views\personalInfo\AlertInfo.vue, Vue, 0, 0, 0, 138, 0, 5, 3, 146
d:\OneDrive\Code\Vscode\Vue\qingblog\src\views\personalInfo\AlertPwd.vue, Vue, 0, 0, 0, 104, 0, 8, 3, 115
d:\OneDrive\Code\Vscode\Vue\qingblog\src\views\personalInfo\MyInfo.vue, Vue, 0, 0, 0, 145, 0, 6, 4, 155
d:\OneDrive\Code\Vscode\Vue\qingblog\vue.config.js, JavaScript, 14, 0, 0, 0, 0, 2, 1, 17
Total, -, 189, 11918, 16, 1623, 21, 175, 84, 14026